11111111111111111111
1C10000000001000C001
101011100C0010011101
10101000000000000001
100C10C00111100C0001
1111100001E010000001
10001010010010001001
10101010010110001C01
1P10C01C00000C001001
11111111111111111111